         ######## 
         #     @# 
         # $#$ ## 
         # $  $#  
         ##$ $ #  
########## $ # ###
#....   ## $  $  #
##...     $  $   #
#....  ###########
########          